############################
#--------------------------#
#-........................-#
#-###########-#####----###-#
#------------##---######-#-#
#-----------------------#--#
#----------------------#---#
#---------------------##---#
#-----------------&&-------#
#---------/-----&&----#----#
#---------/----------#-----#
#---------/----------#-----#
#---------/----------#-----#
#--------------------#-----#
#-------------------#------#
#-------------------#------#
#------------------#-------#
#-----------------#--------#
#----------------##--------#
#--------------------------#
#--------------------------#
#--------------------------#
#--------------------------#
#--------------------------#
#--------------------------#
#--------------------------#
#--------------------------#
#--------------------------#
#--------------------------#
#--------------------------#
############################
