############################
#............##............#
#.####.#####.##.#####.####.#
#.#--#.#---#.##.#---#.#--#.#
#.####.#####.##.#####.####.#
#..........................#
#.####.##.########.##.####.#
#.####.##.########.##.####.#
#......##....##....##......#
######.#####.##.#####.######
-----#.#####.##.#####.#-----
-----#.##..........##.#-----
-----#.##.###--###.##.#-----
######.##.#------#.##.######
..........#------#..........
######.##.#------#.##.######
-----#.##.########.##.#-----
-----#.##..........##.#-----
-----#.##.########.##.#-----
######.##.########.##.######
#............##............#
#.####.#####.##.#####.####.#
#.####.#####.##.#####.####.#
#...##................##...#
###.##.##.########.##.##.###
###.##.##.########.##.##.###
#......##....##....##......#
#.##########.##.##########.#
#.##########.##.##########.#
#..........................#
############################