############################
#--------------------------#
#--------------------------#
#--------......------------#
#--------------...---------#
#---#############----------%
#-------------------/----%%%
#------------------/-----%%%
#-----&&&&&&-------------%%%
#------------------------%%%
#-------------------------%#
#------^-----------------%-#
#-----^------^-----------%-#
#-----^-----^^-------------#
#-----^----^^--------------#
#------^^^^----------------#
#--------------------------#
#--------------------------#
#--------------------------#
#--------------------------#
#--------------------------#
#--------------------------#
#--------------------------#
#--------------------------#
#--------------------------#
#--------------------------#
#--------------------------#
#--------------------------#
#--------------------------#
#--------------------------#
############################
