############################
#/...........##.........../#
#.####.#####.##.#####.####.#
#.#--#.#---#.##.#---#.#--#.#
#.####.#####.##.#####.####.#
#..........................#
#.####.##.########.##.####.#
#.####.##.########.##.####.#
#......##....##....##......#
######.#####.##.#####.######
%%%%%#.#####.##.#####.#%%%%%
%%%%%#.##..........##.#%%%%%
%%%%%#.##.###--###.##.#%%%%%
######.##.#------#.##.######
......../.#-&&&--#./........
######.##.--------.##.######
%%%%%#.##.########.##.#%%%%%
%%%%%#.##..........##.#%%%%%
%%%%%#.##.########.##.#%%%%%
######.##.########.##.######
#............##............#
#.####.#####.##.#####.####.#
#.####.#####.##.#####.####.#
#...##................##...#
###.##.##.########.##.##.###
###.##.##.########.##.##.###
#......##....##....##......#
#.##########.##.##########.#
#.##########.##.##########.#
#/......................../#
############################