############################
#=...........##...........=#
#.####.#####.##.#####.####.#
#.#^-#.#---#.##.#-^-#.#--#.#
#.####.#####.##.#####.####.#
#..........................#
#.####.##.########.##.####.#
#.####.##.########.##.####.#
#......##...^##....##......#
######.#####.##.#####.######
%%%%%#.#####.##.#####.#%%%%%
%%%%%#.##..........##.#%%%%%
%%%%%#.##.###--###.##.#%%%%%
######.##.#------#.##.######
......../.#-&&&&-#./........
######.##.--------.##.######
%%%%%#.##.########.##.#%%%%%
%%%%%#.##..........##.#%%%%%
%%%%%#.##.########.##.#%%%%%
######.##.########.##.######
#............##............#
#.####.#####.##.#####.####.#
#.####.#####.##.#####.####.#
#...##................##...#
###.##.##.########.##.##.###
###.##.##.########.##.##.###
#......##....##^...##.....^#
#.##########.##.##########.#
#.##########.##.##########.#
#/......................../#
############################