############################
.......##..........##.......
######.##.########.##.######
######.##.########.##.######
#............##............#
#.#######.##.##.##.#######.#
#.#######.##.##.##.#######.#
#.##......##.##.##......##.#
#.##.####.##....##.####.##.#
#.##.####.########.####.##.#
#......##.########.##......#
######.##..........##.######
######.##.###--###.##.######
#......##.#------#.##......#
#.####.##.#-&&&&-#.##.####.#
#.####....--------....####.#
#...##.##.########.##.##...#
###.##.##..........##.##.###
%%#.##.####.####.####.##.#%%
%%#.##.####.####.####.##.#%%
%%#.........####.........#%%
%%#.#######.####.#######.#%%
###.#######.####.#######.###
.......##..........##.......
###.##.##.########.##.##.###
###.##.##.########.##.##.###
#...##.......##.......##...#
#.####.#####.##.#####.####.#
#.####.#####.##.#####.####.#
#..........................#
############################