############################
#--------------------------#
#--------------------------#
#--------------------------#
#--------------------------#
#--------------------------#
#--------------------------#
#--------------------------#
#--------------------------#
#--------------------------#
#--------------------------#
#--------------------------#
#---------###--###---------#
#---------#------#---------#
#---------#-&&&&-#---------#
#--------------------------#
#---------########---------#
#--------------------------#
#--------------------------#
#--------------------------#
#--------------------------#
#--------------------------#
#--------------------------#
#--------------------------#
#--------------------------#
#--------------------------#
#--------------------------#
#--------------------------#
#--------------------------#
#--------------------------#
############################