############################
......^##..../.....##.......
######.##.########.##.######
######.##.########.##.######
#............##...........^#
#.#######.##.##.##.#######.#
#.#######.##.##.##.#######.#
#.##......##.##.##......##.#
#.##.####.##..^.##.####.##.#
#.##.####.########.####.##.#
#.../..##.########.##......#
######.##..........##.######
######.##.###--###.##.######
#^.....##.#------#.##......#
#.####.##.#-&&&&-#.##.####.#
#.####....--------....####.#
#...##.##.########.##.##...#
###.##.##..........##.##.###
%%#.##.####.####.####.##.#%%
%%#.##.####.####.####.##.#%%
%%#.........####..../....#%%
%%#.#######.####.#######.#%%
###.#######.####.#######.###
....=..##..........##.......
###.##.##.########.##.##.###
###.##.##.########.##.##.###
#...##.......##......^##...#
#.####.#####.##.#####.####.#
#.####.#####.##.#####.####.#
#..........................#
############################